|   |p  |   |  g| w |
|p  |p  |p  |   |   |
|p  |   |   |   |   |
|   |p  |   |p  |   |
|p  |p  |   |   |   |

|   |   |p  |  g|   |
|   | w |   |   |   |
|p  |   |p  |   |p  |
|   |   |   |   |   |
|   |   |   |p  |p  |

